##############
#......#.....#
#............#
#....######..#
#....#....#..#
#.........#..#
##############
